{
  "level1" : {
    "layer1" : [
      [1,1,1,1,1,1,1,1,1],
      [1,1,1,1,1,1,1,1,1],
      [1,1,1,1,1,1,1,1,1],
      [1,1,1,1,1,1,1,1,1],
      [1,1,1,1,1,1,1,1,1],
      [1,1,1,1,1,1,1,1,1],
      [1,1,1,1,1,1,1,1,1],
      [1,1,1,1,1,1,1,1,1],
      [1,1,1,1,1,1,1,1,1]
    ],
    "layer2" : [
      [1,1,1,1,1,1,1,1,1],
      [1,0,0,0,0,0,0,0,1],
      [1,0,0,0,0,0,0,0,1],
      [1,0,0,0,0,0,0,0,1],
      [1,0,0,0,0,0,0,0,1],
      [1,0,0,0,0,0,0,0,1],
      [1,0,0,0,0,0,0,0,1],
      [1,0,0,0,0,0,0,0,1],
      [1,1,1,1,1,1,1,1,1]
    ],
    "crates" : [
      {"x": 3, "y": 4},
      {"x": 5, "y": 4},
      {"x": 4, "y": 3},
      {"x": 4, "y": 5}
    ],
    "crateAreas" : [
      {"x" : 2, "y" : 4, "sprite" : 4},
      {"x" : 6, "y" : 4, "sprite" : 4},
      {"x" : 4, "y" : 2, "sprite" : 4},
      {"x" : 4, "y" : 6, "sprite" : 4}
    ],
    "playerPos" : {"x" : 4, "y" : 4}
  },

  "level2" : {
    "layer1" : [
      [2,2,2,2,2,1,1,1,1],
      [2,2,2,2,2,1,1,1,1],
      [2,2,2,2,2,1,2,2,2],
      [2,2,2,2,2,1,2,2,2],
      [2,2,2,2,2,2,2,2,2],
      [1,2,2,2,2,2,2,2,2],
      [1,2,2,2,2,2,2,2,2],
      [1,2,2,2,2,2,2,2,2],
      [1,2,2,2,2,2,1,1,1]
    ],
    "layer2" : [
      [1,1,1,1,1,0,0,0,0],
      [1,0,0,0,1,0,0,0,0],
      [1,0,0,0,1,0,1,1,1],
      [1,0,0,0,1,0,1,0,1],
      [1,1,1,0,1,1,1,0,1],
      [0,1,1,0,0,0,0,0,1],
      [0,1,0,0,0,1,0,0,1],
      [0,1,0,0,0,1,1,1,1],
      [0,1,1,1,1,1,0,0,0]
    ],
    "crates" : [
      {"x" : 2, "y" : 2},
      {"x" : 2, "y" : 3},
      {"x" : 3, "y" : 2}
    ],
    "crateAreas" : [
      {"x" : 7, "y" : 3, "sprite" : 5},
      {"x" : 7, "y" : 4, "sprite" : 5},
      {"x" : 7, "y" : 5, "sprite" : 5}
    ],
    "playerPos" : {"x" : 3, "y" : 1}
  },

  "level3" : {
    "layer1" : [
      [0,1,1,1,1,0,0,0,0],
      [1,1,1,1,1,0,0,0,0],
      [1,1,1,1,1,0,0,0,0],
      [1,1,1,1,1,1,0,0,0],
      [1,1,1,1,1,1,0,0,0],
      [1,1,1,1,1,1,0,0,0],
      [1,1,1,1,1,1,0,0,0],
      [1,1,1,1,1,1,0,0,0],
      [0,0,0,0,0,0,0,0,0]
    ],
    "layer2" : [
      [0,1,1,1,1,0,0,0,0],
      [1,1,0,0,1,0,0,0,0],
      [1,0,0,0,1,0,0,0,0],
      [1,1,0,0,1,1,0,0,0],
      [1,1,0,0,0,1,0,0,0],
      [1,0,0,0,0,1,0,0,0],
      [1,0,0,0,0,1,0,0,0],
      [1,1,1,1,1,1,0,0,0],
      [0,0,0,0,0,0,0,0,0]
    ],
    "crates" : [
      {"x" : 3, "y" : 2},
      {"x" : 2, "y" : 3},
      {"x" : 3, "y" : 4},
      {"x" : 2, "y" : 5},
      {"x" : 3, "y" : 6}
    ],
    "crateAreas" : [
      {"x" : 1, "y" : 5, "sprite" : 4},
      {"x" : 1, "y" : 6, "sprite" : 4},
      {"x" : 2, "y" : 6, "sprite" : 4},
      {"x" : 3, "y" : 6, "sprite" : 4},
      {"x" : 4, "y" : 6, "sprite" : 4}
    ],
    "playerPos" : {"x" : 2, "y" : 2}
  },

  "level4" : {
    "layer1" : [
      [1,2,2,2,2,1,1,1,1],
      [1,2,2,2,2,2,2,1,1],
      [1,2,2,2,2,2,2,1,1],
      [2,2,2,2,2,2,2,2,1],
      [2,2,2,2,2,2,2,2,1],
      [2,2,2,2,2,2,2,2,1],
      [2,2,2,2,2,2,2,2,1],
      [2,2,2,2,2,2,2,2,1],
      [1,1,1,1,1,1,1,1,1]
    ],
    "layer2" : [
      [0,1,1,1,1,0,0,0,0],
      [0,1,0,0,1,1,1,0,0],
      [0,1,0,0,0,0,1,0,0],
      [1,1,1,0,1,0,1,1,0],
      [1,0,1,0,1,0,0,1,0],
      [1,0,0,0,0,1,0,1,0],
      [1,0,0,0,0,0,0,1,0],
      [1,1,1,1,1,1,1,1,0],
      [0,0,0,0,0,0,0,0,0]
    ],
    "crates" : [
      {"x" : 3, "y" : 2},
      {"x" : 2, "y" : 5},
      {"x" : 5, "y" : 6}
    ],
    "crateAreas" : [
      {"x" : 1, "y" : 4, "sprite" : 5},
      {"x" : 1, "y" : 5, "sprite" : 5},
      {"x" : 1, "y" : 6, "sprite" : 5}
    ],
    "playerPos" : {"x" : 2, "y" : 1}
  },

  "level5" : {
    "layer1" : [
      [1,1,2,2,2,2,2,2,1],
      [1,1,2,2,2,2,2,2,1],
      [2,2,2,2,2,2,2,2,1],
      [2,2,2,2,2,2,2,2,1],
      [2,2,2,2,2,2,2,2,1],
      [2,2,2,2,2,2,2,1,1],
      [1,1,1,2,2,2,2,1,1],
      [1,1,1,1,1,1,1,1,1],
      [1,1,1,1,1,1,1,1,1]
    ],
    "layer2" : [
      [0,0,1,1,1,1,1,1,0],
      [0,0,1,0,0,0,0,1,0],
      [1,1,1,0,0,0,0,1,0],
      [1,0,0,0,0,0,0,1,0],
      [1,0,0,0,0,0,1,1,0],
      [1,1,1,1,0,0,1,0,0],
      [0,0,0,1,1,1,1,0,0],
      [0,0,0,0,0,0,0,0,0],
      [0,0,0,0,0,0,0,0,0]
    ],
    "crates" : [
      {"x" : 4, "y" : 2},
      {"x" : 5, "y" : 2},
      {"x" : 3, "y" : 3},
      {"x" : 2, "y" : 4}
    ],
    "crateAreas" : [
      {"x" : 3, "y" : 3, "sprite" : 5},
      {"x" : 4, "y" : 3, "sprite" : 5},
      {"x" : 4, "y" : 4, "sprite" : 5},
      {"x" : 5, "y" : 4, "sprite" : 5}
    ],
    "playerPos" : {"x" : 1, "y" : 3}
  },

  "level6" : {
    "layer1" : [
      [2,2,1,1,1,1,1,2,2],
      [1,1,1,1,1,1,1,2,2],
      [1,1,1,1,1,1,1,1,2],
      [1,1,1,1,1,1,1,1,2],
      [1,1,1,1,1,1,1,1,2],
      [2,2,1,1,1,1,1,1,2],
      [2,2,1,1,1,1,1,2,2],
      [2,2,2,2,2,2,2,2,2],
      [2,2,2,2,2,2,2,2,2]
    ],
    "layer2" : [
      [0,0,1,1,1,1,1,0,0],
      [1,1,1,0,0,0,1,0,0],
      [1,0,0,0,0,0,1,1,0],
      [1,0,0,0,0,0,0,1,0],
      [1,1,1,0,0,0,0,1,0],
      [0,0,1,0,0,0,1,1,0],
      [0,0,1,1,1,1,1,0,0],
      [0,0,0,0,0,0,0,0,0],
      [0,0,0,0,0,0,0,0,0]
    ],
    "crates" : [
      {"x" : 3, "y" : 2},
      {"x" : 4, "y" : 3},
      {"x" : 4, "y" : 4},
      {"x" : 5, "y" : 4}
    ],
    "crateAreas" : [
      {"x" : 3, "y" : 3, "sprite" : 4},
      {"x" : 4, "y" : 2, "sprite" : 4},
      {"x" : 4, "y" : 4, "sprite" : 4},
      {"x" : 5, "y" : 3, "sprite" : 4}
    ],
    "playerPos" : {"x" : 5, "y" : 1}
  }
}
  